Alaska: Northwest-Territory Alberta Kamchatka
Northwest-Territory: Alaska Alberta Ontario Greenland
Alberta: Northwest-Territory Alaska Ontario Western-United-States
Western-United-States: Alberta Ontario Eastern-United-States Central-America
Central-America: Western-United-States Venezuela
Eastern-United-States: Western-United-States Ontario Quebec
Ontario: Alberta Western-United-States Greenland Quebec
Quebec: Ontario Greenland Eastern-United-States 
Greenland: Quebec Ontario Northwest-Territory Iceland
Venezuela: Central-America Brazil Argentina
Brazil: Venezuela Argentina North-Africa
Argentina: Venezuela Brazil
North-Africa: Brazil Egypt Congo Western-Europe Southern-Europe
South-Africa: Congo Madagascar East-Africa
Egypt: North-Africa Southern-Europe Middle-East
Congo: North-Africa East-Africa South-Africa
East-Africa: Egypt Congo South-Africa Madagascar
Madagascar: East-Africa South-Africa
Japan: Kamchatka Mongolia
Kamchatka: Alaska Yakutsk Irkutsk Mongolia Japan
Yakutsk: Kamchatka Siberia Irkutsk
Irkutsk: Kamchatka Siberia Mongolia Yakutsk
Mongolia: Irkutsk Siberia Japan China
China: Afghanistan Siberia Mongolia Siam India
Siam: China India Indonesia
India: Middle-East Afghanistan China Siam
Middle-East: Egypt Ukraine-West Afghanistan India
Afghanistan: Ukraine-West Ukraine-East Middle-East China Siberia India
Ukraine-East: Ukraine-West Siberia Afghanistan
Siberia: Ukraine-East Yakutsk Irkutsk Afghanistan China
Iceland: Greenland Great-Britain
Great-Britain: Iceland Scandinavia Northern-Europe Western-Europe
Western-Europe: North-Africa Great-Britain Northern-Europe Southern-Europe
Northern-Europe: Great-Britain Ukraine-West Western-Europe Southern-Europe 
Southern-Europe: North-Africa Egypt Western-Europe Northern-Europe Ukraine-West
Scandinavia: Great-Britain Ukraine-West
Ukraine-West: Scandinavia Northern-Europe Southern-Europe Ukraine-East Afghanistan Middle-East
Indonesia: Siam New-Guinea Western-Australia 
New-Guinea: Eastern-Australia Indonesia Western-Australia
Western-Australia: Indonesia Eastern-Australia New-Guinea
Eastern-Australia: New-Guinea Western-Australia LotR
LotR: Eastern-Australia
